1 1 4 1 1 -1 -1 -1 -1 -1
1 1 1 1 1 -1 -1 -1 -1 -1
1 1 1 1 1 -1 -1 -1 -1 -1
-1 -1 1 1 -1 -1 -1 -1 -1 -1
-1 -1 5 5 -1 -1 -1 -1 -1 -1
-1 -1 5 5 1 1 8 1 1 1
-1 -1 1 1 1 1 8 1 1 1
3 -1 1 1 1 1 8 1 1 1
3 -1 1 1 1 1 1 1 9 1
-1 -1 1 1 1 1 1 1 1 1
