1 8 1 1 1 -1 -1 -1 -1 -1
8 1 1 8 1 -1 -1 -1 -1 -1
-1 -1 1 1 1 -1 -1 -1 -1 3
-1 -1 1 8 1 1 1 4 1 1
-1 -1 -1 5 -1 -1 1 1 1 1
-1 -1 -1 5 -1 -1 -1 -1 -1 -1
-1 -1 1 8 -1 -1 5 5 1 -1
3 -1 8 5 1 8 1 5 1 1
3 -1 8 1 8 5 1 5 9 5
-1 -1 1 1 -1 1 5 1 1 5
