1 1 4 1 1 -1 -1 -1 -1 -1
1 1 1 1 1 -1 -1 -1 -1 -1
-1 -1 1 5 1 -1 -1 -1 -1 -1
-1 -1 -1 5 -1 -1 -1 -1 -1 -1
-1 -1 -1 1 -1 -1 -1 -1 -1 -1
-1 -1 -1 1 1 1 8 8 8 1
-1 -1 1 1 1 1 8 9 8 1
3 -1 1 1 1 1 8 8 8 1
3 -1 1 1 1 1 -1 -1 -1 -1
-1 -1 1 1 1 1 1 -1 -1 -1
